+++++++++++
  +       +
+ +++ +++++
+   +     +
+++ +++++ +
+   + S + +
+ +++ + + +
+ +   + + +
+ +++ + + +
+     +   X
+++++++++++
