+++++++++++
  +   +   +
+ +++ + + +
+   +   + +
+++ + +++ +
+ + +   + +
+ + +++++ +
+ +   +   +
+ +++ + + +
+      S+ X
+++++++++++
