+++++++++++
    +     +
+++ +++++ +
+ + +     +
+ + + +++ +
+ +   +  S+
+ +++++ +++
+     + + +
+ +++++ + +
+         X
+++++++++++
