+++++++++++
          +
+++++++++ +
+       +S+
+ +++++++ +
+       + +
+++++++ + +
+       + +
+ +++++++ +
+         X
+++++++++++
