+++++++++++
          +
+++++++++ +
+       + +
+ +++++++S+
+       + +
+++++++ + +
+       + +
+ +++++++ +
+         X
+++++++++++
