+++++++++++
  +       +
+ + +++++ +
+   + +   +
+++++ + +++
+   +   + +
+ + + +++ +
+ +   +   +
+ +++++++ +
+ S       X
+++++++++++
