+++++++++++
          +
+++++++++ +
+     +   +
+++++ + +++
+     + S +
+ +++ +++ +
+ +     + +
+ +++++++ +
+         X
+++++++++++
