+++++++++++
  +       +
+ + +++++++
+ +       +
+ + +++++ +
+ + + S   +
+ +++ +++ +
+ +   + + +
+ + +++ + +
+   +     X
+++++++++++
