+++++++++++
  +   +   +
+ + + + +++
+   + +   +
+++++ +++ +
+   + +   +
+ +++ + + +
+ +   +S+ +
+ + +++ + +
+       + X
+++++++++++
