+++++++++++
  +   +   +
+ + + + +++
+   + +   +
+++++ +++ +
+   + +   +
+ +++ + + +
+ +   + + +
+ + +++S+ +
+       + X
+++++++++++
